10 10
0010000101
0111000111
1010011111
1001001011
0010101011
1000011011
0001100101
0000101101
1000111001
0101010001
